NO ./path_to_the_north_texture
SO ./path_to_the_south_texture
WE ./path_to_the_west_texture
EA ./path_to_the_east_texture

F 220,100,0
C 225,30,0

1000000000
1100111110
0100000010
0100000010
1100001110
0100001000
1100001111
10P0000001
1000000001
1111111111