NO textures/red_brick.xpm
SO textures/mossy.xpm
WE textures/grey_stone.xpm
EA textures/purple_stone.xpm

F 18,53,25
C 153,204,255

11111111
10000001
100E0001
10000001
10000001
11111111
