N textures/red_brick.xpm


SO textures/mossy.xpm

  EA textures/purple_stone.xpm


WE textures/grey_stone.xpm


F 220,100,0



C 225,30,0

111111111111
111110000011
111111001111
100000N00001
100000000001
111111111111

