NO textures/red_brick.xpm
SO textures/blue_stone.xpm
WE textures/grey_stone.xpm
EA textures/purple_stone.xpm

F 255,0,0
C 0,0,255

111111111111
100000000011
10000N000001
111111111111
