NO textures/red_brick.xpm
SO textures/mossy.xpm
WE textures/grey_stone.xpm
EA textures/purple_stone.xpm

F 18,53,25
C 153,204,255

111111111
10000001
100E001
100000001
111111111
