NO textures/red_brick.xpm
SO textures/mossy.xpm
WE textures/grey_stone.xpm
EA textures/purple_stone.xpm

F 18,53,25
C 153, 204 , 255

1111111111111111111111111111
1000E00000111111111111111111
1111111110000000011111111111
1111111111111110000000000001
1111111111111111111111111111
