NO textures/red_brick.xpm
SO textures/mossy.xpm
WE textures/grey_stone.xpm
EA textures/purple_stone.xpm

F 18,53,25
C 153,204,255

1111111111
1        1
1  1111  1
1 S1     1
1  1111  1
1        1
11111111 1
