NO textures/test/north.xpm
SO textures/test/south.xpm
WE textures/test/west.xpm
EA textures/test/east.xpm

F 122,0,0
C 0,0,333

111111111111
100000000011
100000000001
11   0 111111111
10 S 000000001
11   111111111
100000000001
111111111111
